A->D
B->X
C->M
D->Z
E->A
F->Y
G->I
H->C
I->N
J->G
K->L
L->K
M->O
N->B
O->T
P->U
Q->J
R->F
S->P
T->E
U->V
V->R
W->H
X->Q
Y->S
Z->W
a->d
b->x
c->m
d->z
e->a
f->y
g->i
h->c
i->n
j->g
k->l
l->k
m->o
n->b
o->t
p->u
q->j
r->f
s->p
t->e
u->v
v->r
w->h
x->q
y->s
z->w
 -> 